7 7
#######
#S#   #
# ### #
# #   #
# # # #
#   #e#
#######